0 0 0 0 0 0 0 0 0 0 0 0 0 0 0 0 0 0 0 0 0 0 0 0 0 0 0 0 0 0 
0 0 0 0 0 2 2 2 4 0 0 0 0 0 0 0 0 0 0 0 0 2 2 2 4 2 0 0 0 0 
0 0 0 0 0 2 5 6 6 0 0 0 0 0 0 0 0 0 0 0 0 5 6 6 2 6 0 0 0 0 
0 0 0 0 0 2 2 2 2 3 3 3 3 3 3 0 0 0 0 0 0 2 2 2 2 2 0 0 0 0 
0 0 0 0 0 2 2 2 2 0 0 0 0 0 3 0 0 0 0 0 0 2 2 2 2 2 0 0 0 0 
0 0 0 0 0 0 0 0 0 0 0 0 0 0 3 0 0 0 0 0 0 0 0 3 0 0 0 0 0 0 
0 2 2 2 0 0 0 0 0 0 0 0 0 2 2 2 4 0 0 0 0 0 0 3 0 0 0 0 0 0 
0 4 2 5 0 0 2 2 2 0 0 0 0 2 5 6 6 0 0 0 0 0 0 3 0 0 0 0 0 0 
0 6 2 2 3 3 4 2 5 3 3 3 3 2 2 2 2 3 3 3 3 3 3 3 0 0 0 0 0 0 
0 2 2 2 0 0 2 2 2 0 0 0 0 2 2 2 2 0 0 0 0 0 0 3 0 0 0 0 0 0 
0 0 3 0 0 0 0 0 0 0 0 0 0 0 3 3 0 0 0 0 0 0 0 3 0 0 0 0 0 0 
0 0 3 0 0 0 0 0 0 0 0 0 0 0 3 3 0 0 0 0 0 0 0 3 0 0 0 0 0 0 
0 0 3 0 0 0 0 0 0 0 0 0 0 0 3 3 0 0 0 0 0 0 0 3 0 0 0 0 0 0 
0 0 3 0 0 0 0 0 0 0 0 0 0 0 3 3 0 0 0 0 0 0 0 3 0 0 0 0 0 0 
0 0 3 0 0 0 0 0 0 0 0 0 0 0 3 3 0 0 0 0 0 0 0 3 0 0 0 0 0 0 
0 0 3 0 0 0 0 0 0 0 2 2 2 4 2 5 6 0 0 0 0 0 0 3 0 0 0 0 0 0 
0 0 3 0 0 0 0 0 0 0 6 2 6 6 6 5 2 0 0 0 0 0 0 3 0 0 0 0 0 0 
0 0 3 3 3 3 3 3 3 3 2 2 2 2 2 2 2 0 0 0 2 2 2 4 2 5 0 0 0 0 
0 0 0 0 0 0 0 0 0 0 2 2 2 2 2 2 2 0 0 0 6 6 2 6 6 6 0 0 0 0 
0 0 0 0 0 0 0 0 0 0 2 2 2 2 2 2 2 3 3 3 2 2 2 2 2 2 0 0 0 0 
0 0 0 0 0 0 0 0 0 0 0 2 2 2 4 2 5 6 0 0 2 2 2 2 2 2 0 0 0 0 
0 0 0 0 0 0 0 0 0 0 0 6 2 6 2 2 2 2 0 0 2 2 2 2 2 2 0 0 0 0 
0 0 0 0 0 0 0 0 0 0 0 2 2 2 2 2 2 2 0 0 0 0 0 0 0 0 0 0 0 0 
0 0 0 0 0 0 0 0 0 0 0 0 0 0 0 0 0 0 0 0 0 0 0 0 0 0 0 0 0 0 
0 0 0 0 0 0 0 0 0 0 0 0 0 0 0 0 0 0 0 0 0 0 0 0 0 0 0 0 0 0 
0 0 0 0 0 0 0 0 0 0 0 0 0 0 0 0 0 0 0 0 0 0 0 0 0 0 0 0 0 0 
0 0 0 0 0 0 0 0 0 0 0 0 0 0 0 0 0 0 0 0 0 0 0 0 0 0 0 0 0 0 
0 0 0 0 0 0 0 0 0 0 0 0 0 0 0 0 0 0 0 0 0 0 0 0 0 0 0 0 0 0 
0 0 0 0 0 0 0 0 0 0 0 0 0 0 0 0 0 0 0 0 0 0 0 0 0 0 0 0 0 0 
0 0 0 0 0 0 0 0 0 0 0 0 0 0 0 0 0 0 0 0 0 0 0 0 0 0 0 0 0 0 
