0 0 0 0 0 0 0 0 0 0 0 0 0 0 0 0 0 0 0 0 0 0 0 0 0 0 0 0 0 0 
0 0 0 0 0 0 0 0 0 0 0 0 0 0 0 0 0 0 0 0 0 0 0 0 0 0 0 0 0 0 
0 0 0 0 0 0 0 0 0 0 0 0 0 0 0 0 0 0 0 0 0 0 0 0 0 0 0 0 0 0 
0 0 0 0 0 0 0 0 0 0 0 0 0 13 13 13 13 13 0 0 0 11 11 11 0 0 0 0 0 0 
0 0 0 0 0 0 0 0 0 11 11 11 11 13 13 13 13 13 0 0 0 11 11 11 0 0 0 0 0 0 
0 0 0 0 0 0 0 0 0 11 11 11 11 13 13 13 13 13 0 0 0 11 11 11 0 0 0 0 0 0 
0 0 0 0 0 0 0 0 0 11 11 11 11 13 13 13 13 13 3 3 3 11 11 11 0 0 0 0 0 0 
0 0 0 3 3 3 3 3 3 11 11 11 11 13 13 13 13 13 0 0 0 11 11 11 0 0 0 0 0 0 
0 0 0 3 0 0 0 0 0 11 11 11 11 13 13 13 13 13 0 0 0 0 0 0 0 0 0 0 0 0 
0 0 0 3 0 0 0 0 0 11 11 11 11 13 13 13 13 13 0 0 0 0 0 0 0 0 0 0 0 0 
0 0 12 12 12 0 0 0 0 0 0 3 0 0 0 3 0 0 0 0 0 0 0 0 0 0 0 0 0 0 
0 0 12 12 12 0 0 0 0 0 0 3 0 0 0 3 0 0 0 0 0 0 0 0 0 0 0 0 0 0 
0 0 12 12 12 0 0 0 0 0 0 3 0 0 0 3 0 0 0 0 0 0 0 0 0 0 0 0 0 0 
0 0 12 12 12 0 0 0 0 0 0 3 0 0 0 3 0 0 0 0 0 0 0 0 0 0 0 0 0 0 
0 0 12 12 12 0 0 0 0 0 0 3 0 0 0 3 0 0 0 0 0 0 0 0 0 0 0 0 0 0 
0 0 0 3 0 0 0 0 0 0 0 3 0 0 0 3 0 0 0 0 0 0 0 0 0 0 0 0 0 0 
0 0 0 3 0 0 0 0 0 0 0 3 0 0 0 3 0 0 0 0 0 0 0 0 0 0 0 0 0 0 
0 0 0 3 0 0 0 0 0 0 0 3 0 0 0 3 0 0 0 0 0 0 0 0 0 0 0 0 0 0 
0 0 0 3 0 0 0 0 0 0 0 3 0 0 0 11 11 11 11 11 11 11 0 0 0 0 0 0 0 0 
0 0 0 3 0 0 0 0 0 0 0 3 3 3 3 11 11 11 11 11 11 11 0 0 0 0 0 0 0 0 
0 0 0 3 0 0 0 0 0 0 0 0 0 3 0 11 11 11 11 11 11 11 0 0 0 0 0 0 0 0 
0 0 0 3 0 0 0 0 0 0 0 0 0 3 0 0 0 0 3 0 0 0 0 0 0 0 0 0 0 0 
0 0 0 3 0 0 0 0 0 0 11 11 11 11 11 11 11 0 3 0 0 0 0 13 13 13 13 13 13 0 
0 0 0 3 0 0 0 0 0 0 11 11 11 11 11 11 11 0 3 0 0 0 0 13 13 13 13 13 13 0 
0 0 0 3 3 3 3 3 3 3 11 11 11 11 11 11 11 3 3 3 3 3 3 13 13 13 13 13 13 0 
0 0 0 0 0 0 0 0 0 0 0 0 0 0 0 0 0 0 0 0 0 0 0 13 13 13 13 13 13 0 
0 0 0 0 0 0 0 0 0 0 0 0 0 0 0 0 0 0 0 0 0 0 0 0 0 0 0 0 0 0 
0 0 0 0 0 0 0 0 0 0 0 0 0 0 0 0 0 0 0 0 0 0 0 0 0 0 0 0 0 0 
0 0 0 0 0 0 0 0 0 0 0 0 0 0 0 0 0 0 0 0 0 0 0 0 0 0 0 0 0 0 
0 0 0 0 0 0 0 0 0 0 0 0 0 0 0 0 0 0 0 0 0 0 0 0 0 0 0 0 0 0 
